000000000000000000000000000000000000000000000000000000000000000
0                                                             0
0   X                                                         0
0                                                             0
0                                                             0
0                                                             0
0                                                             0
0                                                             0
0                                                             0
0                                                             0
0                                                             0
0                                                             0
0                                                             0
0                                                             0
0                                                             0
0                                                             0
0                                                             0
0                                                             0
0                                                             0
0                                                             0
0                                                             0
0                                                             0
0                                                             0
0                                                     U       0
0                                                             0
000000000000000000000000000000000000000000000000000000000000000
